###################
#P****************#
#*##*###*##*#####*#
#*##***#*#**####**#
#**###*#*#*##****##
##*###***#***s#####
##*****############
###################