###################
#P****************#
#*##*###*##*#####*#
#*##***#*#**####**#
#**###*#*#*##****##
##*###***#***G#####
##*****############
###################